S...■...
■■■.■■■.
.■.....■
■■■.■■■.
....■..E