S.................
■■■■■.■■■■■■■■■...
..............■■..
.■■■■■■■■■.■■■■■..
...............E..